10 10
2
0 0
9 9
2
3 1
6 8
0 0 0 0 0 0 2 2 0 0
0 0 0 0 0 0 0 0 0 0
0 0 2 2 0 0 0 0 0 0
0 0 2 2 0 0 0 0 0 2
0 0 0 0 0 0 0 0 0 2
0 0 0 0 0 0 0 0 0 2
2 0 0 0 0 2 2 0 0 0
2 0 0 0 0 2 2 0 0 0
0 0 0 0 0 0 0 0 0 0
0 0 2 0 0 0 0 0 0 0
